11111111
10E00001
1C0000P1
11111111