111111111
10E001111
1C0P01111
111111111